1111111111
1P00000001
1001111101
1C00000101
1011100101
1000000101
1001110101
1C000000E1
1011111111
1111111111
