111111
1P0001
100001
1C0001
100101
1C00E1
1M0001
111111
