1111111111
1P000000C1
1011101101
1C000001E1
1111111111
