1111111111111111111111111111
1P00010000000001000000100001
1010101011111010101010111001
1010101000000010101000000001
1010111011101010111011111001
1000000010101000001000000001
1111111010101111101011111111
1000000010100000001010000001
1011111010111111101010111101
1010001000000000000010000101
1010111011111111111011100101
1C0000000000000C0000000000E1
100000000000C000000000000001
1111111111111111111111111111
