1111111111111111111111111111
1P00000000000000000000000001
1000111111111110000011111001
100010000000001C000010C00001
1000100000000010000010000001
1000111111111110000011111001
100000000000C000000000000001
10000000000000M0000000000001
1000001111111111111110000001
1000001000000000000010000001
1000001000000000000010000001
10000011111111111111100000E1
1000000C00000000000000000001
1111111111111111111111111111
