1111111
1P000C1
1000101
1C01101
10000E1
1111111
